                            
             _______) _     
          _/      _/ /      
  |\_____/_/\  __/  | \     
  /          \      )  |    
 | (|     ()  |\ _ /   /    
|___  ..   _.      \__ /     
\___\_____/  __/      \      
    \------'     (    )     
    |   )---(   |/ <__/     
     \<_/   <__/            
                            